█████████████████████████████
█           █            P  █
█  $        █               ► 
█           ████████        █
█       █               !   █
█       █           B       █
█   H   █                   █
█████████████████████████████
